w w w w w w w w w w w w w w w w w w w w w w w w w w w
w c c c c c c c c c c c c c c c c c c c c c c c c c w
w c c c c c c c c c c c c c c c c c c c c c c c c c w
w c c w c c c c c c c c c c c c c c c c c c c w c c w
w c c c c c c c c c c c c c c c c c c c c c c c c c w
w c c c c c c c c c c w w o w w c c c c c c c c c c w
w c c c c c c c c c c w b b b w c c c c c c c c c c w
w c c c c c c c c c c w b g b w c c c c c c c c c c w
w c c c c c c c c c c w w w w w c c c c c c c c c c w
w c c w c c c c c c c c c p c c c c c c c c c w c c w
w c c c c c c c c c c c c c c c c c c c c c c c c c w
w c c c c c c c c c c c c c c c c c c c c c c c c c w
w w w w w w w w w w w w w w w w w w w w w w w w w w w
