w w w w w w w w w w w w w w w w w w w w w w w w w w w
w s c c c c c c c c c c c c c c c c c c c c c c c s w
w c w w w w c w c c c w w w w w c c c w c w w w w c w
w c w w w w w w w w w w c c c w w w w w w w w w w c w
w c c c c c c c c c c c c c c c c c c c c c c c c c w
w c w w w w w w w w w w w o w w w w w w w w w w w c w
w c w w c c c w c c c w b b b w c c c c c c c w w c w
w c w c c w c w c w c w b g b w c w c c c w c c w c w
w c w w w w c c c c c w w w w w c c c w c w w w w c w
w c w c c c c w w w c w c p c w w w w w c c c c w c w
w c w w w w w w w w w w c c c w w w w w w w w w w c w
w s c c c c c c c c c c c c c c c c c c c c c c c s w
w w w w w w w w w w w w w w w w w w w w w w w w w w w
